412 413 413  413  413  413 413 413  413  413  413  413  413 413 413 413 413 413 413 413 413 413 413 413 413 413  413  413  413  413  413 413 413 413 413 413 413 413 413 413 413 413 413 413 413 413 413 413 413 413 413 413 413 413 413  413  413  413  413  413 413 413 413 413 413 413 413 413 413 413 413 413 413 413 413 413 413 413 413 413 413 413 413 413 413 413 413 413  413  413  413 413 413 413 413 413 413 413 413 413 413 413 413 413 414
416 248 248  248  248  265 217   4    4    4    4    4    4 353 248 248 248 248 248 248 353 353 353 248 248 248  248  248  248  248  248 248 248 248 248 248 248 248 248 248 248 248 248 248 248 248 248 248 248 353 353 248 248 248 248  248  248  248  248  248 248 248 248 248 248 248 248 248 248 353 353 252 252 252 252 252 252 180 181 182 183 248 248 248 248 248 248 248  248  248  248 248 248 248 248 248 248 248 248 248 248 248 248 248 418
416   0   0    0    0    0   0   4    4    4    4    4    4 248 248 248 248 248 353 248 248 248 248 248 248 248  248  248  248  248  353 248 248 248 248 248 248 248 248 248 248 248 248 248 248 248 248 248 248 248 248 248 248 248 248  248  248  248  248  248 248 248 248 248 248 248 248 248 248 248 353 252 252 252 252 252 252 184 185 186 187 252 248 252 252 252 252 252  252  252  248 248 248 248 248 248 248 248 248 248 248 248 248 248 418
416   0   0    0    0    0   0   4    4    4    4    4    4 248 248 265   5   5   5   5   5   5 248 248 353 248  248  248  248  353  248 248 248 248 248 248 248 248 248 248 248 248 248 248 248 248 248 248 248 248 248 248 248 248 248  248  248  248  248  248 248 248 248 248 248 248 248 248 353 252 252 252 252 252 252 252 252 176 177 178 179 256 252 256 256 256 256 256  256  256  252 248 248 248 248 248 248 248 248 248 248 248 248 248 418
416   0   0    0    0    0   0   4    4    4    4    4    4 248 248 265   5   5   5   5   5   5 248 248 224 225  226  227  248  248  248 248 248 248 248 248 353 248 248 248 353 248 248 248 248 248 248 248 248 353 248 248 248 248 248  248  248  248  248  248 248 248 248 248 248 248 248 252 252 252 252 252 252 252 252 252 252 176 177 178 179 252 256 256 256 252 252 252  252  252  248 252 248 248 248 248 248 248 248 248 248 248 248 248 418
416   0   0    0    0    0   0   4    4    4    4    4    4 248 248 265   5   5   5   5   5   5 248 248 228 229  230  231  248  224  225 226 227 353 353   6   6   6   6   6   6 353 248 248 248 353 248 248 248 248 353 248 248 248 248  248  248  248  248  248 248 248 248 248 353 252 252 217 265 252 252 252 252 252 252 252 252 176 177 178 179 252 248 248 256 256 256 256  256  248  248 248 248 248 252 252 248 248 248 248 248 248 248 248 418
416   0   0    0    0    0   0 265  248  248  248  248  248 248 248 265   5   5   5   5   5   5 248 248 232 233  234  235  353  228  229 230 231 248 248   6   6   6   6   6   6 265 265 265 265 265 265 265 265 265 265 265 265 265 265  265  265  265  265  265 265 265 265 265 265 265 265 217 265 252 252 252 252 252 252 252 252 176 177 178 179 248 248 252 252 252 248 248  248  248  248 252 248 256 256 256 248 248 248 248 248 248 248 248 418
416 248 248  248  248  265 217 265  248  248  248  248  248 248 248 265   5   5   5   5   5   5 248 248 236 237  238  239  353  232  233 234 235 248 248   6   6   6   6   6   6 218 216 216 216 216 216 216 216 218 265 265 265 265 265  265  265  265  265  265 265 265 265 265 265 265 265 217 265 252 252 252 252 252 252 252 252 188 189 190 191 248 248 248 248 248 252 252  252  248  252 248 248 248 248 248 248 248 248 248 248 248 248 248 418
416 256 248 1296 1296 1296 217 265  248  248  248  248  248 248 248 265 217 265 353 248 248 248 248 353 353 248  248  248  248  236  237 238 239 248 248   6   6   6   6   6   6   6 272 273 248  10  10  10  10  10 265 265 265 265 265  265  265  265  265  265 265 265 265 265 265 265 265 217 265 252 252 252 252 252 252 252 252 192 193 194 195 252 252 252 252 252 256 256  256  248  248 248 256 252 252 252 248 248 248 248 248 248 248 248 418
416 248 248 1296 1296 1296 217 265  248  248  248  248  248 248 248 265 217 265 353 248 248 248 248 248 248 248  353  248  248  248  248 353 248 248 248   6   6   6   6   6   6   6 276 277 248  10  10  10  10  10 265 248 248 248 248  248  248  248  248  248 248 248 248 248 248 248 265 217 265 252 252 252 252 252 252 252 252 196 197 198 199 256 256 256 256 256 256 248  248  248  256 256 256 256 256 256 256 248 248 248 248 248 248 248 418
416 248 248 1296 1296 1296 217 265  248  248  248  248  248 248 248 265 217 265 353 248 353 353 353 248 248 248  248  248  248  248  248 353 353 248 248 353 353 248 248 248 265 217 248 248 248  10  10  10  10  10 265 248 248 248 248  248  248  248  248  248 248 248 248 248 248 248 265 217 265 265 265 265 265 265 265 265 265 265 265 265 265 265 265 265 265 265 265 265  265  265  265 265 265 265 265 265 265 265 265 265 265 265 265 265 418
416 248 256 1296 1296 1296 217 265  265  265  265  265  265 265 265 265 217 265 265 265 265 265 265 265 265 265  265  265  265  265  265 265 265 265 265 265 265 265 265 265 265 217 248 248 248  10  10  10  10  10 265 248 248 248 248  248  248  248  248  248 180 183 248 248 248 248 265  15  15  15  15  15  15  15 216 216  16  16  16  16  16  16  16  16  16  16  16  16  216  216  216 216 216 216 216 216 216 216 216 216 216 216 216 216 418
416 248 248 1296 1296 1296 217 216  216  216  216  216  216 216 216 216 218 216 216 216 216 216 216 216 216 216  216  216  216  216  216 216 216 216 216 216 216 216 216 216 216 218 248 248 248  10  10  10  10  10 265 248 248 248 248  248  248  248  248  248 184 187 180 181 181 182 183  15  15  15  15  15  15  15 265 265  16  16  16  16  16  16  16  16  16  16  16  16  272  273  272 273 272 273 272 273 272 273 272 273 272 273 272 273 418
416 256 248  248  248  265 217 265  248  248  248   41   41  41 353  41   7   7   7   7   7 265 265 265 265 217  265  265  265  265  265 265 265 265 265 265 265 265 265 265 265   9   9   9   9   9   9 248 248 217 265 248 248 248 248  248  248  248  248  248 192 193 184 185 185 186 187  15  15  15  15  15  15  15 248 248  16  16  16  16  16  16  16  16  16  16  16  16  276  277  276 277 276 277 276 277 276 277 276 277 276 277 276 277 418
416 248 248  248  248  265 217 265  248  248  248   41  353 353 353  41   7   7   7   7   7 248 248 248 265 217  224  225  226  227  248 228 229 230 231 248 248 248 248 248 265   9   9   9   9   9   9 248 248 217 265 248 248 248 248  248  248  248  248  248 192 193 193 194 193 194 195  15  15  15  15  15  15  15 248 248  16  16  16  16  16  16  16  16  16  16  16  16  272  273  353 353 353 353 353 353 353 353 353 353 353 353 272 273 418
416   1   1    1    1    1   1 265  248  248  248   41  353 353 353  41   7   7   7   7   7 248 248 248 265 217  228  229  230  231  248 232 233 234 235 248 248 248 248 248 265   9   9   9   9   9   9 248 248 217 265 248 248 248 248  248  248  248  248  248 192 193 193 194 193 194 195  15  15  15  15  15  15  15 248 248  16  16  16  16  16  16  16  16  16  16  16  16  276  277  353 353 353 353 353 353 353 353 353 353 353 353 276 277 418
416   1   1    1    1    1   1 265  248  248  248   41  353 353 353  41   7   7   7   7   7 248 248 248 265 217  232  233  234  235  248 236 237 238 239 248 248 248 248 248 265   9   9   9   9   9   9 248 248 217 265 248 248 248 248  248  248  248  248  248 192 193 193 194 193 194 195  15  15  15  15  15  15  15 248 248  16  16  16  16  16  16  16  16  16  16  16  16  272  273  353 353 353 353 353 353 353 353 353 353 353 353 272 273 418
416   1   1    1    1    1   1  18   18   18  248   41  353 353 353 353   7   7   7   7   7 248 248 248 265 217  236  237  238  239  248 248 248 248 248 248 248 248 248 248 265   9   9   9   9   9   9 248 248 217 265 248 248 248 248  248  248  248  248  248 192 193 194 194 194 194 195  15  15  15  15  15  15  15 248 248  16  16  16  16  16  16  16  16  16  16  16  16  276  277  353 353 353 353 353 353 353 353 353 353 353 353 276 277 418
416   1   1    1    1    1   1  18   18   18  248   41   41  41  41  41 217 265 248 248 248 248 248 248 265 217  224  225  226  227  248 248 248 224 225 226 227 248 248 248 265 217 248 248 248 248 248 248 248 217 265 248 248 248 248  248  248  248  248  248 196 197 198 198 198 198 199  15  15  15  15  15  15  15 248 248  16  16  16  16  16  16  16  16  16  16  16  16  272  273  353 353 353 353 353 353 353 353 353 353 353 353 272 273 418
416   1   1    1    1    1   1 265  265  265  265  265  265 265 265 265 217 265 248 248 248 248 248 248 265 217  228  229  230  231  248 248 248 228 229 230 231 248 248 248 265 219 216 216 216 216 216 216 216 219 265 248 248 248 248  248  248  248  248  248 248 248 248 248 248 248 248  15  15  15  15  15  15  15 248 248  16  16  16  16  16  16  16  16  16  16  16  16  276  277  353 353 353 353 353 353 353 353 353 353 353 353 276 277 418
416 256 248  248  256  265 217 243  243  243  243  243  243 243 243 243 217 265 248 248 248 248 248 248 265 217  232  233  234  235  248 248 248 232 233 234 235 248 248 248 265 217 265 265 265 265 265 265 265 217 224 225 226 227 248  248  248  248  248  248 248 248 248 248 248 248 248 217 265 248 248 248 248 248 248 248  16  16  16  16  16  16  16  16  16  16  16  16  272  273  353 353 353 353 353 353 353 353 353 353 353 353 272 273 418
416 248 248  248  248  265 217 265  265  265  265  265  265 265 265 265 217 265 248 248 248 248 248 248 265 217  236  237  238  239  248 248 248 236 237 238 239 248 248 248 265 217 265 248 248 224 225 226 227 217 228 229 230 231 248  248  248  248  248  248 248 248 248 248 248 248 248 217 265 248 248 248 248 248 248 248  16  16  16  16  16  16  16  16  16  16  16  16  276  277  353 353 353 353 353 353 353 353 353 353 353 353 276 277 418
416 248 248  248  248  265 217  41   41   41   41   41   41  41  41  41   8   8   8   8   8 248 248  18  18  18  216  216  216  216  216 216 216 216 216 216 216 216 216 216 216 219 265 248 248 228 229 230 231 217 232 233 234 235 248  248  248  248  248  248 248 248 248  14  14  14  14 217 265 248 248 248 248 248 248 248  16  16  16  16  16  16  16  16  16  16  16  16  272  273  353 353 353 353 353 353 353 353 353 353 353 353 272 273 418
416 248 248  248  248  265 217  41  353  353  353   41  353 353 353  41   8   8   8   8   8 248 248  18  18  18  265  265  265  265  265 265 265 265 265 265 265 265 265 265 265 265 265 248 248 232 233 234 235 217 236 237 238 239 248  248  248  248  248  248 248 248 248  14  14  14  14 217 265 248 248 248 248 248 248 248  16  16  16  16  16  16  16  16  16  16  16  16  276  277  353 353 353 353 353 353 353 353 353 353 354 354 276 277 418
416 256 248  248  248  265 217  41  353  353  353   41  353 353 353  41   8   8   8   8   8 248 248 248 265 217  248  248  248  248  248 248 248 248 248 248 248 248 248 248 248 248 248 248 248 236 237 238 239 217 265 248 248 248 248  248  248  248  248  248 248 248 248  14  14  14  14 217 265 248 248 248 248 248 248 248 188 190 191  16  16  16  16  16  16 191 265 217  272  273  353 353 353 353 353 353 353 353 353 353 354 354 272 273 418
416 248 248  248  248  265 217  41  353  353  353   41  353 353 353 353   8   8   8   8   8 248 248  18  18  18  248  248  248  248  248 248 248 248 248 248 248 248 248 248 248 248 248 248 248 248 248 248 265 217 265 248 248 248 248  248  248  248  248  248 248 248 248  14  14  14  14 217 265 248 248 248 248 248 248 248 248 248 248  16  16  16  16  16  16 248 265 217  272  273  353 353 353 353 353 353 353 353 353 353 358 358 272 273 418
416 256 248  248  248  265 217  41  353  353  353   41  353 353 353  41   8   8   8   8   8 248 248  18  18  18  248  248  248  248  248 248 248 248 248 248 248 248 248 248 248 248 248 248 248 248 248 248 265 217 265 248 248 248 248  248  248  248  248  248 248 248 248  14  14  14  14 217 265 248 248 248 248 248 248 248 192 194 195  16  16  16  16  16  16 195 265 217  276  277  353 353 353 353 353 353 353 353 353 353 358 354 276 277 418
416 256 248  248  248  265 217  41  353  353  353  353  353 353 353  41 217 265 248 248 248 248 248 248 265 217  248  248  248  248  248 248 248 248 248 248 248 248 248 248 248 248 248 248 248 248 248 248 265 217 265 248  13  13  13   13   13   13  248  248 248 248 248  14  14  14  14 217 265 248 248 248 248 248 248 248 248 253 253  16  16  16  16  16  16 253 265 217  276  277  353 353 353 353 353 353 353 353 353 353 358 358 276 277 418
416   2   2    2    2    2   2  41   41  353   41   41   41  41  41  41 217 265 248 248 248 248 248  18  18  18 1296 1296 1296 1296 1296 248 248 248 248 248 248 248 248 248 248 248 248 248 248 248 248 248 265 217 265 248  13  13  13   13   13   13  248  248 248 248 248  14  14  14  14 217 265 248 248 248 248 248 248 248 248 257 257  16  16  16  16  16  16 257 265 217  272  273  272 273 272 273 272 273 272 273 272 273 272 273 272 273 418
416   2   2    2    2    2   2 265  265  265  265  265  265 265 265 265 217 265 248 248 248 248 248  18  18  18 1296 1296 1296 1296 1296 318 318 318 318 318 318 318 318 318 318 318 318 318 318 318 318 318 265 217 265 248  13  13  13   13   13   13  248  248 248 248 248  14  14  14  14 217 265 265 265 265 265 265 265 265 265 265 265  16  16  16  16  16  16 265 265 217  276  277  276 277 276 277 276 277 276 277 276 277 276 277 276 277 418
416   2   2    2    2    2   2 265  564  565  265  265  564 565 265 265 217 265 265 265 265 265 265  18  18  18 1296 1296 1296 1296 1296 265 265 265 265 265 265 265 265 265 265 265 265 265 265 265 265 265 265 217 265 265  13  13  13   13   13   13  564  565 265 265 265  14  14  14  14 219 216 216 216 216 216 216 216 216 216 216 216  16  16  16  16  16  16 216 216 216  216  216  216 216 216 216 216 216 216 216 216 216 216 216 216 216 418
416   2   2    2    2    2   2 216  216  216  216  216  216 216 216 216 219 216 216 216 216 216 216  18  18  18  216  216  216  216  216 216 216 216 216 216 216 216 216 216 216 216 216 216 216 216 216 216 216 216 216 216  13  13  13   13   13   13  216  216 216 216 216  14  14  14  14 216 216 216 216 216 216 216 216 216 216 216 216  16  16  16  16  16  16 216 216 216  216  216  216 216 216 216 216 216 216 216 216 216 216 216 216 216 418
416   2   2    2    2    2   2 265  265  265  265  265  265 265 265 265 217 265 265 265 265 265 265 265 265 217  265  265  265  265  265 265 265 265 265 265 265 265 265 265 265 265 265 265 265 265 265 265 265 265 265 265 265 265 265 1296 1296 1296 1296 1296 217 265 265 265 265 265 265 265 265 265 217 265 265 265 265 265 265 265 265 265 217 265 265 265 265 265 265 265  265  265  265 217 265 265 265 265 265 265 265 265 265 265 265 265 418
416 248 248  256  248  265 217 265  313  314  314  314  314 314 315 265 217 248 248 248 248 248 248 248 265 217  265  318  318  318  318 318 318 318 318 318 318 318 318 318 318 318 318 318 318 318 318 318 318 318 318 318 318 318 265 1296 1296 1296 1296 1296 217 265 248 248 248 248 248 248 248 265 217 248 248 248 248 248 248 248 248 248 217 265 248 248 248 248 248 248  248  248  265 217 265 248 248 248 12 12 12 12 248 248 248 248 248 418
416 248 248  248  248  265 217 265  317  318  318  318  318 318 319 265 217 248 248 248 248 248 248 248 265 217  265  318  318  353  353 353 353 353 353 353 353 353 353 353 353 353 353 353 353 353 353 353 353 353 353 353 353 318 265 1296 1296 1296 1296 1296 217 265 248 248 248 248 248 248 248 265 217 248 248 248 248 248 248 248 248 248 217 265 248 248 248 248 248 248  248  248  265 217  11  11  11  11 12 12 12 12  12  12  12  12  418
416 256 248  248  248  265 217 265  317  318  318  318  318 318 319 265 217 248 248 248 248 248 248 248 265 217  265  318  353  353  353 353 353 353 353 353 353 353 353 353 353 353 353 353 353 353 353 353 353 353 353 353 353 353 265  265  218  216  216  216 219 265 248 248 248 248 248 248 265 265 219 216 216 216 216 216 216 216 216 216 219 265 248 248 248 248 248 248  248  248  265 217  11  11  11  11 12 12 12 12  12  12  12  12  418
416 248 248  248  248  265 217 265  317  318  318  318  318 318 319 265 217 248 248 248 248 248 248 248 265 217  265  318  353  353  353 353 353 353 353 353 353 353 353 353 353 353 353 353 353 353 353 353 353 353 353 353 353 353 318  265  217  265  265  265 217 265 248 248 248 248 248 248 265 180 181 182 183 217 217 180 181 182 183 265 265 265 248 248 248 248 248 248  248  248  265 217  11  11  11  11 12 12 12 12  12  12  12  12  418
416 256 248  248  256  265 217 265  317  318  318  318  318 318 319 265 217 248 248 248 248 248 248 248 265 217  265  318  353  353  353 353 353 353 353 353 353 353 353 353 353 353 353 353 353 353 353 353 353 353 353 353 353 353 318  265   18   18   18  265 217 265 248 248 248 248 248 248 265 184 185 186 187 217 217 184 185 186 187 265 248 248 248 248 248 248 248 248  248  248  265 217  11  11  11  11 12 12 12 12  12  12  12  12  418
416   3   3    3    3    3   3 265  321  322  322  322  322 322 323 265 217 248 248 248 248 248 248 248 265 217  265  318  353  353  353 353 353 353 353 353 353 353 353 353 353 353 353 353 353 353 353 353 353 353 353 353 353 353 318  265   18   18   18  265 217 265 248 248 248 248 248 248 265 188 189 190 191 217 217 188 189 190 191 265 248 248 248 248 248 248 248 248  248  248  265 217  11  11  11  11 12 12 12 12  12  12  12  12  418
416   3   3    3    3    3   3 265  265  265  265  265  265 265 265 265 217 248 248 248 248 248 248 248 265 217  265  318  353  353  353 353 353 353 353 353 353 353 353 353 353 353 353 353 353 353 353 353 353 353 353 353 353 353 318  265   18   18   18  265 217 265 248 248 248 248 248 248 265 192 193 194 195 217 217 192 193 194 195 265 248 248 248 248 248 248 248 248  248  248  265 217  11  11  11  11 12 12 12 12  12  12  12  12  418
416   3   3    3    3    3   3 216  216  216  216  216  216 216 216 216 219 248 248 248 248 248 248 248 265 217  265  318  353  353  353 353 353 353 353 353 353 353 353 353 353 353 353 353 353 353 353 353 353 353 353 353 353 353 318  265   18   18   18  216 219 265 248 248 248 248 248 248 265 196 197 198 199  17  17 196 197 198 199 265 248 248 248 248 248 248 248 248  248  248  265 217  11  11  11  11 12 12 12 12  12  12  12  12  418
416   3   3    3    3    3   3 265 1296 1296 1296 1296 1296 248 248 248 248 354 248 353 248 354 248 353 265 217  265  318  353  353  353 353 353 353 353 353 353 353 353 353 353 353 353 353 353 353 353 353 353 353 353 353 353 353 318  265  217  265  265  265 265 265 248 248 265 265 265 265 265 265 265 265 265  17  17 265 265 265 265 265 248 248 248 248 248 248 248 265  265  265  265 217  11  11  11  11 12 12 12 12  12  12  12  12  418
416   3   3    3    3    3   3 265 1296 1296 1296 1296 1296 248 248 248 357 248 248 358 248 353 248 358 265 217  265  318  353  353  353 353 353 353 353 353 353 353 353 353 353 353 353 353 353 353 353 353 353 353 353 353 353 353 318  265  217  265  248  248 248 248 248 248 265  17  17  17  17  17  17  17  17  17  17  17  17  17 265 265 248 248 248 248 248 248 248 265 1296 1296 1296  11  11  11  11  11 12 12 12 12  12  12  12  12  418
416 256 256  248  256  265 217 265 1296 1296 1296 1296 1296 248 357 353 180 181 182 181 182 181 182 183 265 217  265  318  353  353  353 353 353 353 353 353 353 353 353 353 353 353 353 353 353 353 353 353 353 353 353 353 353 353 318  265  217  265  248  248 248 248 248 248 265  17  17  17  17  17  17  17  17  17  17  17  17  17 265 248 248 248 248 248 248 248 248 265 1296 1296 1296  11  11  11  11  11 12 12 12 12  12  12  12  12  418
416 248 248  248  248  265 217 265  248  248  248  248  248 248 248 354 184 185 186 185 186 185 186 187 265 217  265  318  353  353  353 353 353 353 353 353 353 353 353 353 353 353 353 353 353 353 353 353 353 353 353 353 353 353 318  265  217  265  248  248 248 248 248 248 265  17  17  17  17  17  17  17  17  17  17  17  17  17 265 248 248 248 248 248 248 248 248 265 1296 1296 1296  11  11  11  11  11 12 12 12 12  12  12  12  12  418
416 256 248  248  248  265 217 265  248  248  248  248  248 248 357 358 393 393 394 393 394 393 394 394 265 217  265  318  353  353  353 353 353 353 353 353 353 353 353 353 353 353 353 353 353 353 353 353 353 353 353 353 353 353 318  265  217  265  248  248 248 248 248 248 265  17  17  17  17  17  17  17  17  17  17  17  17  17 265 248 248 248 248 248 248 248 248 265 1296 1296 1296 217 265 265 265 265 265 265 265 265 265 265 265 265 418
416 248 248  248  248  265 217 265  248  248  248  248  248 248 391 400 393 393 394 393 394 393 394 394 265 217  265  318  353  353  353 353 353 353 353 353 353 353 353 353 353 353 353 353 353 353 353 353 353 353 353 353 353 353 318  265  217  265  248  248 248 248 248 248 265  17  17  17  17  17  17  17  17  17  17  17  17  17 265 248 248 248 248 248 265 265 265 265 1296 1296 1296 217 265 248 248 200 201 202 203 248 200 201 202 203 418
416 256 248  248  248  265 217 265  248  248  248  248  248 248 395 393 394 393 394 393 394 393 394 394 265 217  265  318  353  353  353 353 353 353 353 353 353 353 353 353 353 353 353 353 353 353 353 353 353 353 353 353 353 353 318  265  217  265  248  248 248 248 248 248 265  17  17  17  17  17  17  17  17  17  17  17  17  17 265 248 248 248 248 248 265 218 216 216  216  216  216 217 265 248 248 204 205 206 207 248 204 205 206 207 418
416 256 248  248  248  265 217 265  248  248  248  248  248 248 395 393 394 393 394 393 394 393 394 394 265 217  265  318  318  353  353 353 353 353 353 353 353 353 353 353 353 353 353 353 353 353 353 353 353 353 353 353 353 318 318  265  217  265  248  248 248 248 248 248 265  17  17  17  17  17  17  17  17  17  17  17  17  17 265 248 248 248 248 248 265 217 200 201  202  203   -1 217 265 248 248 208 209 210 211 248 208 209 210 211 418
416 248 248  256  248  265 217 265  248  248  248  248  248 248 399 394 394 397 398 393 394 393 394 394 265 217  265  265  265  265  265 265 265 265 265 265 265 265 265 265 265 265 265 265 265 265 265 265 265 265 265 265 265 265 265  265  217  265  265  265 265 265 265 265 265  17  17  17  17  17  17  17  17  17  17  17  17  17 265 248 248 248 248 248 265 217 204 205  206  207   -1 217 265 248 248 212 213 214 215 248 212 213 214 215 418
416 248 248  248  248  265 217 265  248  248  248  248  248 248 248 248 248 248 248 265 218 216 216 216 216 216  216  216  216  216  216 216 216 216 216 216 216 216 216 216 216 216 216 216 216 216 216 216 216 216 216 216 216 216 216  216  216  216  216  216 216 216 216 216 216  17  17  17  17  17  17  17  17  17  17  17  17  17 265 248 248 248 248 248 265 217 208 209  210  211   -1 217 200 201 202 203 248 248 248 248 248 248 248 248 418
416 256 248  248  248  265 217 265  248  248  248  248  248 248 248 248 248 248 248 265 217 265 265 265 265 265  265  265  265  265  265 265 265 265 265 265 265 265 265 265 265 265 265 265 265 265 265 265 265 265 265 265 265 265 265  265  265  265  265  265 265 217 265 265 265  17  17  17  17  17  17  17  17  17  17  17  17  17 265 248 248 248 248 248 265 217 212 213  214  215   -1 217 204 205 206 207 248 248 248 248 248 248 248 248 418
416 256 248  248  248  265 217 265  248  248  248  248  248 248 248 248 248 248 248 265 217 265 248 248 248 180  181  182  183  180  181 182 183 180 181 182 183 180 181 182 183 180 181 182 183 248 248 248 248 248 248 248 248 248 248  248  248  248  248  248 265 217 265 248 200 201 202 203 265 265 265 265 265 265 265 200 201 202 203 265 248 248 248 248 265 217  -1 200  201  202  203 217 208 209 210 211 248 248 248 248 248 248 248 248 418
416 248 248  256  248  265 217 265  265  265  265  265  265 265 265 265 265 265 265 265 217 265 248 248 248 184  185  186  187  184  185 186 187 184 185 186 187 184 185 186 187 184 185 186 187 248 248 248 248 248 248 248 248 248 248  248  248  248  248  248 265 217 265 248 204 205 206 207 248 248 248 248 248 248 248 204 205 206 207 265 248 379 388 389 390 217  -1 204  205  206  207 217 212 213 214 215 248 248 248 248 248 248 248 248 418
416 248 248  248  248  265 219 216  216  216  216  216  216 216 216 216 216 216 216 216 219 265 248 248 248 188  189  190  191  188  189 190 191 188 189 190 191 188 189 190 191 188 189 190 191 248 248 248 248 248 248 248 248 248 248  248  248  248  248  248 265 217 265 248 208 209 210 211 248 248 248 248 248 248 248 208 209 210 211 265 248 383 392 393 394 217  -1 208  209  210  211 217 265 248 248 248 248 248 248 248 248 248 248 248 418
416 256 248  248  256  265 265 265  265  265  265  265  265 265 265 265 265 265 265 265 265 265 248 248 248 192  193  194  195  192  193 194 195 192 193 194 195 192 193 194 195 192 193 194 195 248 248 248 248 248 248 248 248 248 248  248  248  248  248  248 265 217 265 265 212 213 214 215 265 265 265 265 265 265 265 212 213 214 215 265 265 387 396 397 398 217  -1 212  213  214  215 217 265 248 248 248 248 248 248 248 248 248 248 248 418
416 248 248  248  248  248 248 248  248  248  248  248  248 248 248 248 248 248 248 248 248 248 248 248 248 188  189  190  191  188  189 190 191 188 189 190 191 188 189 190 191 188 189 190 191 248 248 248 248 248 248 248 248 248 248  248  248  248  248  248 265 219 216 216 216 216 216 216 216 216 216 216 216 216 216 216 216 216 216 216 216 216 216 216 216 219 216 216  216  216  216 219 265 248 248 248 248 248 248 248 248 248 248 248 418
416 248 248  248  248  248 248 248  248  248  248  248  248 248 248 248 248 248 248 248 248 248 248 248 248 192  193  194  195  192  193 194 195 192 193 194 195 192 193 194 195 192 193 194 195 248 248 248 248 248 248 248 248 248 248  248  248  248  248  248 265 265 265 265 265 265 265 265 265 265 265 265 265 265 265 265 265 265 265 265 265 265 265 265 265 265 265 265  265  265  265 265 265 248 248 248 248 248 248 248 248 248 248 248 418
416 248 248  248  248  248 248 248  248  248  248  248  248 248 248 248 248 248 248 248 248 248 248 248 248 248  248  248  248  248  248 248 248 248 248 248 248 248 248 248 248 248 248 248 248 248 248 248 248 248 248 248 248 248 248  248  248  248  248  248 248 248 248 248 248 248 248 248 248 248 248 248 248 248 248 248 248 248 248 248 248 248 248 248 248 248 248 248  248  248  248 248 248 248 248 248 248 248 248 248 248 248 248 248 418
420 421 421  421  421  421 421 421  421  421  421  421  421 421 421 421 421 421 421 421 421 421 421 421 421 421  421  421  421  421  421 421 421 421 421 421 421 421 421 421 421 421 421 421 421 421 421 421 421 421 421 421 421 421 421  421  421  421  421  421 421 421 421 421 421 421 421 421 421 421 421 421 421 421 421 421 421 421 421 421 421 421 421 421 421 421 421 421  421  421  421 421 421 421 421 421 421 421 421 421 421 421 421 421 422
